WWWWWWWWWWWWWWWW
W..............W
W..T.....E.....W
W..............W
W......B.......W
W..............W
W..............W
W..E.....E.....W
W..............W
WWWWWWWWWWWWWWWW
